ISO	Country
AUS	Australia
AUT	Austria
BEL	Belgium
CAN	Canada
CZE	Czech Republic
DNK	Denmark
EST	Estonia
FIN	Finland
FRA	France
DEU	Germany
GRC	Greece
HUN	Hungary
ISL	Iceland
IRL	Ireland
ITA	Italy
JPN	Japan
KOR	Korea
LVA	Latvia
LUX	Luxembourg
MEX	Mexico
NLD	Netherlands
NZL	New Zealand
NOR	Norway
POL	Poland
PRT	Portugal
SVK	Slovak Republic
SVN	Slovenia
ESP	Spain
SWE	Sweden
CHE	Switzerland
TUR	Turkey
GBR	United Kingdom
USA	United States
BRA	Brazil
COL	Colombia
LTU	Lithuania